111111111
1P0000101
1000CE101
111111111
