1111111111
1P00001111
10CE001111
1111111111
